#########################
x@......................#
#$$$$$$$$$$$$$$$$$$$$$$.#
# $.....................#
#  $..$$$$$$$$$$$$$$$$$$#
#   $...................#
#    $$$$$$$$$$$$$$$$$$.#
#     $.................#
#      $..$$$$$$$$$$$$$$#
#       $...............#
#        $$$$$$$$$$$$$$.#
#         $.............#
#          $.L$$$$$$$$$$#
#           $...........#
#            $$$$$$$$$$.#
#             $.........#
#              $..$$$$$$#
#               $.......#
#                $$$$$$.#
#                 $.....#
#                  $..$$#
#                   $...#
#                    $$.#
#                     $.x
#######################x#
